Chez Panisse	currentOwner	Alice Waters
The French Laundry	currentOwner	Thomas Keller
Spago	currentOwner	Wolfgang Puck
Commander's Palace	currentOwner	Brennan Family Restaurants
21 Club	currentOwner	Belmond Ltd.
21 Club	currentOwner	Marshall S. Cogan and Stephen Swid
21 Club	currentOwner	Jack Kreindler and Charlie Berns and families
Frontera Grill	currentOwner	Rick Bayless
Eskimo Joe's	currentOwner	Stan Clark
Ithaa	currentOwner	Conrad Hotels
The Ivy	currentOwner	Richard Caring
Cheese Board Collective	currentOwner	Worker cooperative
Belmond Le Manoir aux Quat'Saisons	currentOwner	Belmond
The Waterside Inn	currentOwner	Alain Roux
Jumbo Kingdom	currentOwner	Stanley Ho
Becky's Diner	currentOwner	Becky Rand
The Inn at Little Washington	currentOwner	Patrick O'Connell
Brennan's	currentOwner	Terry White and Ralph Brennan
Amigo	currentOwner	Yeung Wing Chung
Masa	currentOwner	Masa Takayama
Le Cirque	currentOwner	Sirio Maccioni
Alinea	currentOwner	Grant Achatz
Alinea	currentOwner	Nick Kokonas
The Four Seasons Restaurant	currentOwner	The Bronfman family, Alex von Bidder, and Julian Niccolini
Noma	currentOwner	René Redzepi and Marc J. Blazer
Le Bernardin	currentOwner	Eric Ripert
Le Bernardin	currentOwner	Maguy Le Coze
Chez Dominique	currentOwner	Hans Välimäki
Frog and the Peach	currentOwner	Bruce Lefebvre
Ad Hoc	currentOwner	Thomas Keller
Napa Rose	currentOwner	Walt Disney Parks and Resorts, a subsidiary of The Walt Disney Company
Union Square Cafe	currentOwner	Union Square Hospitality Group
Hard Times Cafe	currentOwner	Worker cooperative
Tribeca Grill	currentOwner	Robert De Niro, Drew Nieporent, and Lou Diamond Phillips, among others
De Librije	currentOwner	Jonnie Boer
De Librije	currentOwner	Thérèse Boer-Tausch
Belgo	currentOwner	Casual Dining Group
Blue Hill	currentOwner	Dan, David, and Laureen Barber
Ciné de Chef	currentOwner	CJ CGV
Michel Richard Citronelle	currentOwner	Michel Richard
Old Ebbitt Grill	currentOwner	Clyde's Restaurant Group
Leopold Cafe	currentOwner	Iranis, Sherezad Dastur, New York City, Pers and Company.
Joël Robuchon	currentOwner	Joël Robuchon
The Kitchin	currentOwner	Tom Kitchin
Iggy's	currentOwner	Ignatius Chan
Restaurant Patrick Guilbaud	currentOwner	Patrick Guilbaud
The Box Tree	currentOwner	Simon Gueller, Rena Gueller, []
Gidleigh Park	currentOwner	Andrew Brownsword
Milk & Honey	currentOwner	Jonathan Downey & Sasha Petraske
Dickie Brennan's Steakhouse	currentOwner	Brennan Family Restaurants
L'Atelier de Joël Robuchon	currentOwner	Joël Robuchon
Father's Office	currentOwner	Sang Yoon
Schwa	currentOwner	Michael Carlson
Matsugen	currentOwner	The Matsushita Brothers, Jean-Georges
Daniel	currentOwner	Daniel Boulud
T-Room	currentOwner	Dalhousie University
Uchi	currentOwner	Tyson Cole
Jake's Famous Crawfish	currentOwner	McCormick & Schmick's
Pied à Terre	currentOwner	David Moore
Colony	currentOwner	Carlo Spetale
Colony	currentOwner	John Lacombe
Next	currentOwner	Grant Achatz
Next	currentOwner	Nick Kokonas
Ford's Filling Station	currentOwner	Benjamin Ford
Wd~50	currentOwner	Wylie Dufresne
Per Se	currentOwner	Thomas Keller
The Great Gritzbe's Flying Food Show	currentOwner	Rich Melman
Restaurant Vermeer	currentOwner	NH Hoteles
Sukiyabashi Jiro	currentOwner	Jiro Ono
Au Crocodile	currentOwner	Cedric Moulot
Eleven Madison Park	currentOwner	Will Guidara and Daniel Humm
Seward Community Cafe	currentOwner	Worker cooperative
De Echoput	currentOwner	Peter Klosse
Nolet Het Reymerswale	currentOwner	Danny Nolet
FLIP Burger Boutique	currentOwner	Ron Stewart
FLIP Burger Boutique	currentOwner	Barry Mills
FLIP Burger Boutique	currentOwner	Richard Blais
Little Grill Collective	currentOwner	Worker cooperative
Muller	currentOwner	Jean-Michel Hengge
Pops	currentOwner	Aubrey McClendon
Pok Pok	currentOwner	Andy Ricker
La Société	currentOwner	INK Entertainment
Conflict Kitchen	currentOwner	Jon Rubin and Dawn Weleski
The Cube	currentOwner	Electrolux
Locks Brasserie	currentOwner	Sébastien Masi
Aniar	currentOwner	JP McMahon and Drigín Gaffey
Au Pied de Cochon	currentOwner	Martin Picard
Aubergine	currentOwner	London Fine Dining Group
Manresa	currentOwner	David Kinch
Picasso	currentOwner	Julian Serrano
Café Boulud	currentOwner	Daniel Boulud
Bouley	currentOwner	David Bouley
El Bajío	currentOwner	Carmen Ramírez Degollado
Gramercy Tavern	currentOwner	Danny Meyer, Michael Anthony, Kevin Mahan
Gotham Bar and Grill	currentOwner	Alfred Portale
Balthazar	currentOwner	Keith McNally
St. Lars restaurant	currentOwner	Andreas Viestad, Per Meland and Tor Erik Hermansen
Osteria Francescana	currentOwner	Massimo Bottura
Central Restaurante	currentOwner	Virgilio Martínez Véliz
Gordon Ramsay Plane Food	currentOwner	Gordon Ramsay
Campagne	currentOwner	Gareth Byrne and Brid Hannon
Murano	currentOwner	Angela Hartnett
Mr. B's Bistro	currentOwner	Cindy Brennan
Toqué!	currentOwner	Normand Laprise and Christine Lamarche
Sofra	currentOwner	Hüseyin Özer
Tony Luke's	currentOwner	Tony Luke, Jr.
Union Street Café	currentOwner	Gordon Ramsay
Bouchon	currentOwner	Thomas Keller
Pine Tavern	currentOwner	William McCormick
Marini's on 57	currentOwner	Modesto Marini
Chiltern Firehouse	currentOwner	André Balazs
The girl & the fig	currentOwner	Sondra Bernstein
Lasan	currentOwner	Aktar Islam
Lasan	currentOwner	Jabbar Khan
Brasserie Lipp	currentOwner	Groupe Bertrand
Angelina	currentOwner	Groupe Bertrand
Sci-Fi Dine-In Theater Restaurant	currentOwner	Walt Disney Parks and Resorts
A16	currentOwner	Shelley Lindgren
Level 257	currentOwner	Namco Entertainment
Mama Melrose's Ristorante Italiano	currentOwner	Walt Disney Parks and Resorts
50's Prime Time Café	currentOwner	Walt Disney Parks and Resorts
Trew Era Cafe	currentOwner	Russell Brand
ABC Commissary	currentOwner	Walt Disney Parks and Resorts
Hollywood & Vine	currentOwner	Walt Disney Parks and Resorts
Ichimura at Brushstroke	currentOwner	David Bouley
Coral Reef Restaurant	currentOwner	Walt Disney Parks and Resorts
Theory Eatery	currentOwner	Bon Appétit Management Company
Sons & Daughters	currentOwner	Teague Moriarty and Matt McNamara
Del Frisco's Double Eagle Steak House	currentOwner	Del Frisco's Restaurant Group
Tony's Pizza Napoletana	currentOwner	Tony Gemignani
Zahav	currentOwner	Steven Cook
Zahav	currentOwner	Michael Solomonov
Buddakan	currentOwner	Starr Restaurant Organization
Bacchanal Buffet	currentOwner	Caesars Entertainment Corporation
The Man Behind The Curtain	currentOwner	Michael O'Hare
Tetsu	currentOwner	Masa Takayama
Kappo Masa Restaurant	currentOwner	Masa Takayama
Loam	currentOwner	Enda McEvoy
Attica	currentOwner	Ben Shewry
Restaurant 9501	currentOwner	ABS-CBN Corporation
Heron and Grey	currentOwner	Andrew Heron and Damien Grey
