Detroit Red Wings	headCoach	Jeff Blashill
Ottawa Senators	headCoach	Guy Boucher
Montreal Canadiens	headCoach	Michel Therrien
New Jersey Devils	headCoach	John Hynes
New York Rangers	headCoach	Alain Vigneault
New York Islanders	headCoach	Jack Capuano
Philadelphia Flyers	headCoach	Dave Hakstol
Pittsburgh Penguins	headCoach	Mike Sullivan
Boston Bruins	headCoach	Claude Julien
Buffalo Sabres	headCoach	Dan Bylsma
Toronto Maple Leafs	headCoach	Mike Babcock
Carolina Hurricanes	headCoach	Bill Peters
Florida Panthers	headCoach	Gerard Gallant
Colorado Avalanche	headCoach	Jared Bednar
Tampa Bay Lightning	headCoach	Jon Cooper
Washington Capitals	headCoach	Barry Trotz
Columbus Blue Jackets	headCoach	John Tortorella
Chicago Blackhawks	headCoach	Joel Quenneville
Minnesota Wild	headCoach	Bruce Boudreau
Edmonton Oilers	headCoach	Todd McLellan
Dallas Stars	headCoach	Lindy Ruff
Anaheim Ducks	headCoach	Randy Carlyle
Vancouver Canucks	headCoach	Willie Desjardins
Los Angeles Kings	headCoach	Darryl Sutter
Arizona Coyotes	headCoach	Dave Tippett
Nashville Predators	headCoach	Peter Laviolette
San Jose Sharks	headCoach	Peter DeBoer
Pittsburgh Pirates	headCoach	Odie Cleghorn 1925–1929
Pittsburgh Pirates	headCoach	Frank Fredrickson  1929–1930
TKH Toruń	headCoach	Oleg Malashkevich
Calgary Flames	headCoach	Glen Gulutzan
St. Louis Blues	headCoach	Ken Hitchcock
Winnipeg Jets	headCoach	Paul Maurice
